#######################################################################
#                                            ##                       #
#########                          ##########                         #
#                                                                     #
#.....                               ..........                       #
#                                                                     #
#                                                    ............     #
#                                                                     #
#                                  ##                                 #
###########                        ############                       #
###########                        ############                       #
#........                          ##........                         #
#                                  ##                                 #
#                                  ##                                 #
#                                                                     #
#..........                          ..........                       #
#                                                                     #
#  ############                        ############                   #
#                                                                     #
#                                                                     #
#...........                         ...........                      #
#                                  ##                   ###########   #
#                                  ##                                 #
#                                  ##                                 #
#  ........                        ##  ........                       #
#                                  ##                                 #
########                           #########                          #
#                                                                .....#
#             ###############                                         #
#                                                                     #
#                                                                     #
#                                                              ########
#                                                                     #
#                                                                     #
#######################################################################